EEEEEEEETTTTEEEEEEEE
EEEEEEEEEEEEEEEEEEEE
EEEEEEETTEEEEEEEEEEE
EEETEEEEEEEEEEEETEEE
EEEEEETEEEEEEWEEEEEE
EEEEEEEEETEEEEEEEEEE
EEEEEEEEEEEEEEEEEEEE
EEEEEEEEEEEEEEEEEEEE
EEEEEEEEETTTEWWEEEEE
EEEEEEWEEEEEEEEWEEEE
EETEEEEEEEEEEEEEEEEE
EEEEEEEEETEEEEEEEEEE
EEEEEEEEEEEEEEEEEEEE
EEEEEEEEEEEEEEEEEEEE
EEEEEEEEWWEEEEEEEEEE
EEEEEEEEETEEEEEEEEEE
EEEEEEEEETTTTEEEEEEE
EEEEEEEEEEEEEEEEEEEE
EEETEEEWWEEEEEEEEEEE
EEEEEEEEEEEETEEEEEEE