GGGTGGGGGGGGGGGGGGGG
GGTTTGGTTTTGGGGGGGGG
GGGTTTTTGGGGGGGGGGGG
WGGGGGGGGGGGGGGGGGWW
WWGGGGGGGGGGGGGGWWWW
WGGGGGGGGGGGGGGWWWWW
GGGGGTTTTTTTGGGGGWWW
GGGGGGGGTTGGGGGGGGGW
GGGGGGGGGGGGGGGGGGGG
GGGWWGGGGGGGGGGGGGGG
GGWWWWGGGGGGGGGGGGGG
GGGWWTTTTTTTTTTGGGGG
GGGGWWWWTTTGGGGGGGGG
GGGGGGWGGTTTTGGGGGGG
GGGGGGGGGGGGGGGGGGGG
GGGGGGGGGGGGGGGGGGGW
GGGGGGGGGGGGGGGGGGGW
GGGTTTGGGGGGGGGGWWWW
GGGGGGGGGGGGGWWWWWWW
GGGGGGGGGGGWWWWWWWWW